7 7
WWWWWWW
W0000GW
WWW0W0W
W0WAW0W
W0W0WWW
WS000aW
WWWWWWW